111111111
1EC010001
1P0C00C01
111111111