1111111
10000C1
1011001
1P1E001
1111111