1111111111111
10010P00E00C1
111111111111