111111111111111111111
10000000E0000100000C1
1C1011111111010010101
101110001P0101011111
100000000C00C000000C1
111111111111111111111