111111111111111111111
10100C00E0000100000C1
1C1011111111010010101
111110001001010111111
100000P00C00C000000C1
111111111111111111111