111111111111111111111
10000C00E0000100000C1
1C1011111111010010101
111111101001010111111
100000P10C00C000000C1
111111111111111111111